NO ./textures/brick_017.xpm
SO ./textures/brick_024-2.xpm
WE ./textures/city_014.xpm
EA ./textures/nature_07.xpm

F 224,245,66
C 66,245,206

    1
   111
   101
111101111
11000N11
111101111
   101
   111
   111
    1
   111
    1
         1111
         1011
 111     1211
 11111111111
 11111111111