NO ./textures/brick_017.xpm
SO ./textures/brick_024-2.xpm
WE ./textures/city_014.xpm
EA ./textures/nature_07.xpm

F 224,245,66
C 66,245,206


            11111111111111111
1111111111  10000000000000001                              111
4000000201  111211111121111111111111111111111111111111    11011
4000000201  1000001 1101100000000001000000000000000001   1100011
1111111101  1001001 1121101111111101001100011100011001  110000011
       101  1010101 1000101000000101001100011100011001 11000000011
       101  1001001 10001010111101010000000111000000011100000000011
       101  1000001 10N010101001010100110000000001100110000000000011
       101  1001001 10001010000101010000000111000000011100000000011
       101  1010101 1000101111110101001100011100011001 11000000011
       101  1001001 1000100000000101001100011100011001  110000011
       101  1000001 1000111111111101000000000000000001   1100011
       101  111211111121111111111121111111112111111111111111211
       101  10000020000000000000000000000000000000000000000001
       101  11111111111111111111111111111111111111111111111121
       1011110100010001000100010001000100010001000100010001001
       1000020001000100010001000100010001000100010001000100001
       1111110100010001000100010001000100010001000100010001001
            11111111111111111111111111111111111111111111111111
