NO ./textures/brick_017.xpm
SO ./textures/brick_024-2.xpm
WE ./textures/city_014.xpm
EA ./textures/nature_07.xpm

F 224,245,66
C 66,245,206



           1
          101
         10001
        1001001
       100101001
      10010001001
     1001001001001
    100100101001001
   10010010S01001001
  1001001012101001001
 100100100101001001001
  1001001011101001001
   10010010001001001
    100100121001001
     1001000001001
      10010001001
       100101001
        1000001
         10001
          101
           1