NO ./textures/brick_017.xpm
SO ./textures/brick_024-2.xpm
WE ./textures/city_014.xpm
EA ./textures/nature_07.xpm

F 224,245,66
C 66,245,206


           1
          111
         11011
        1100011
       110020011
      11001010011
     1100100010011
    110010010010011
   11001001010010011
  1100100100010010011
 110010010000010010011
11001001001N10010010011
 110010010010010010011
  1100100100010010011
   11001001210010011
    110010000010011
     1100100010011
      11001110011
       110000011
        1100011
         11011
          111
           1