NO ./textures/confusedgui_smol.xpm
SO ./textures/brick_024-2.xpm
WE ./textures/city_014.xpm
EA ./textures/nature_07.xpm

F 224,245,66
C 66,245,206





                                       1111111111
                                  1111111111111111111
                              1111111111       11111111
                       111111111111               1111111
                    111100000111                    111111
                  111000000011111                    11111
                  10000000111 111                     1111
                  1000000011  111111    11111111111   1111
                  100000001111111111   11000002222111 1111
                  1111111111111111    11100000221111111111
                 1111    1111111111  1111000N0011 11111111
                1111111  1111111111  11110000001  11111111
               11111111111111111      11100000011111 11111
              111111111111111111111111111100111111  11111
             1111            11111111111111111      11111
            11111                       111111     11111
           11111                                   11111
          11111                                   11111
         11111                                   111111
        11111                        11          11111
        11111                       111  111    11111
        1111                       1111  111   11111                           111111
        1111                       1111 1111   1111                         11111111111
        1111                       111 1111   1111                        111111    1111
        1111                      111  1111  11111                       11111      111
        1111                      111 1111   1111                      111111      111
        1111                     111 1111    1111 111111111111       111111      1111
        1111                     1111111     111111111111111111111 111111       1111
        1111                    1111111      111111  111    11111111111       11111
        1111                    11 111       111     1111      11111        11111
         1111                 1111 111            1111111111111111        111111
         1111               11111   1111         1111111111111111111    1111111
          1111             11111  111 111                    111111111    11111111
          1111             1111111111111               111       111111        11111
           1111               11111  11               1111         11111  111111111
           111111                                                   1111    11111
            111111                                111               1111      111
              1111111                             111               1111      111
                11111111                          111               1111111111111
     1111       11111111111                       1111            11111111111111
     111111    11111  11111111111                              111111
     111 1111 1111  1111 1111111111111111            111    1111111
     111   11111  11111       111111111111  11111111111111111111
      111    11 11111         11111  11111 111111111111111111
       111    11111           1111111111   111       1111
        111111111             111111111   111
         111111               1111       1111
           1                   1111     1111
                                1111   1111
                                 111111111
                                  111111
                                    11
