NO ./textures/wall_1.xpm
SO ./textures/wall_2.xpm
WE ./textures/wall_3.xpm
EA ./textures/wall_4.xpm


F 220,100,0
C 225,30,0


1111111111111111111111111
1000000000000000000000001
1000011110000000000000001
1000010000000011110000001
100000100000N010000000001
1000010000000011110000001
1000100000000000000000001
1111111111111111111111111