NO ./textures/wall_1.xpm
SO ./textures/wall_2.xpm
WE ./textures/wall_3.xpm
EA ./textures/wall_4.xpm

F 220,1,0
C 255,30,0


        1111111111111111111111111
        1000000000110000000000001
        10110000011100000000W0001
        1001000000000000000000001
111111111011000001110000000000001
100000000011000001110111111111111
11110111111111011100000000001
111101111 1111011101010010001
11000000110101011100000010001
10000100000000001100000010001
10000000000000001101010010001
11000001110101011111011110101
11110111 1110101 101111010001
11111111 1111111 11111111111