NO ./textures/brick_017.xpm
SO ./textures/brick_024-2.xpm
WE ./textures/city_014.xpm
EA ./textures/nature_07.xpm

F 224,245,66
C 66,245,206


111111   111111111    11111
100011   100000001111110001
101021   1000N0002000020101
100011   100000001111110001
111111   111121111    11111
