NO ./textures/brick_017.xpm
SO ./textures/brick_024-2.xpm





WE ./textures/city_014.xpm
EA ./textures/nature_07.xpm

F 224,245,66
C 66,245,206

111111111111111111111111111111
100000000100000000000000000001
100000110100000000000000000001
100000010100000000001000000001
10000001010000000001N000000001
100000010000000000000000000001
111111111100000000000000000001
         111111111000001111111
                 111011
                   101
                   101
                   111
