NO ./textures/brick_017.xpm
SO ./textures/brick_024-2.xpm
WE ./textures/city_014.xpm
EA ./textures/nature_07.xpm

F 224,245,66
C 66,245,206

           1
          101
         10001
        1001001
       100101001
      10010001001
     1001001001001
    100100101001001
   10010010001001001
  1001001012101001001
 100100100101001001001
  1001001011101001001
   10010010001001001
    100100121001001
     1001000001001
      10010001001
       100101001
        1000001
         10001
          101
          101
111111111110111111111111111111
1000000001000000000000000000011
10000011010000000111111100000011
1000000101000000010N0001000000011
10000001010000000200000100000000011
1000000100000000010000010000000001111
11111111110000000111111100000000001111111111111111111111111111111111111111111111111111111111111111111111111111111111111
         10000000000000000000000000200000000000000000000000000000000000000001000000000000000000000000000000000000000001
         11100000000000000000000000111111111111111111111111111111111111111100011111111111111111111111111111111111111111
1111111111110011111111111111111111111                                     11011
1100000000100000000000000011                                               101
1000000000000000000000000001111111111                                      101
1000000001000000000000000000000000001                                      101
1111111111111121111111111111211111111                                      101
             101           101                                             101
             101           101111111111111111111111111111111111111111111111101
             101           100000000000000000000000000000000000000000000000001
             101           101111111111111101111111111121111111111111111111111
             101           101   100000020101         101
             101           101   101111111101         101 
           1110111    111  101   101111111101         101
           1000001    101 1101   100000000001         101
           1000001111111111101111111111111111         121
           1001000000000000001                        111
           1000001111111111111
           1000001
           1111111
