NO ./textures/brick_017.xpm
SO ./textures/brick_024-2.xpm
WE ./textures/city_014.xpm
EA ./textures/nature_07.xpm

F 224,245,66
C 66,245,206

111111111111111111111111111111
100000110100000000000000000001   11111
10000001010000S00000100000000111110001
10000001010000000001000000000000000101
10000001000000000000000000000111110001
111111111111111111111111111111   11111
1