NO ./textures/brick_017.xpm
SO ./textures/brick_024-2.xpm
WE ./textures/city_014.xpm
EA ./textures/nature_07.xpm

F 224,245,66
C 66,245,206


111111111111111111111111111111
1000000001000000000000000000011
10000011010000000111111100000011
100000010100000001000001000000011
10000001010000000000S0100000000011
1000000100000000010000010000000001111
1111111111000000011111110000000000111
         1000000000000000000000000011
         1110000000000000000000000011
1111111111110011111111111111111111111
1100000000100000000000000011
1000000000000000000000000001111111111
1000000001000000000000000000000000001
1111111111111111111111111111111111111