NO ./textures/brick_017.xpm
SO ./textures/brick_024-2.xpm
WE ./textures/city_014.xpm
EA ./textures/nature_07.xpm

DO ./textures/door.xpm

F 255,245,66
C 0,245,206


11111111111111111111111111111111111111111111111111111111111111111
10000000000100000000001000000000010000000000100000000001000000001
10000000000100000000000000000000010000000000000000000001000000001
10000000000000000000001000121210000000000000100000000000000000001
10000000000100000000000000000000010000000000000000000001000000001
10000000000100000000001000000000020000000000100000000001000000001
111110000000000000000000000S0000010000000000000000000000000000001
    1000000000010000100100111100000001000000000010000000000100001111111
    1000000000010001110101000121000010000000111111100000001000000000001
    1000000000010000100100100000001111111000000010000000000100000000001
    1000000000010000000000100000000001000000000010000000000100000000001
    1111111111111111111111111111111111111111111111111111111111111111111