NO ./textures/brick_017.xpm
SO ./textures/brick_024-2.xpm
WE ./textures/city_014.xpm
EA ./textures/nature_07.xpm


F 224,245,66
C 66,245,206


11111111111111111111111111111111111111111111111111111111111111111
10000000000100000000001000000000010000000000100000000001000000001
10000000000100000000000000000000010000000000000000000001000000001
10000000000000000000001000000000000000000000100000000000000000001
10000000000100000000000000000000010000000000000000000001000000001
10000000000100000000001000000000010000000000100000000001000000001
100000000000000000000000000E0000000000000000000000000000000000001
10000000000100000001001111000000010000000000100000000001000000001
10000000000100000010101000000000010000000111111100000001000000001
10000000000100000001001000000011111110000000100000000001000000001
10000000000100000000001000000000010000000000100000000001000000001
11111111111111111111111111111111111111111111111111111111111111111
